[
  [[12],  [12],  [12],  [12],  [12],  [12],  [12],  [12],  [12],  [12],  [12],  [12],  [12],  [12],  [12],  [12],  [12],  [12],  [12],  [12]],
  [[12],  [30],  [33],  [  ],  [  ],  [  ],  [  ],  [  ],  [32],  [12],  [  ],  [  ],  [  ],  [  ],  [  ],  [  ],  [  ],  [  ],  [  ],  [12]],
  [[12],  [20],  [  ],  [12],  [12],  [12],  [  ],  [20],  [  ],  [12],  [  ],  [  ],  [  ],  [  ],  [  ],  [  ],  [  ],  [  ],  [  ],  [12]],
  [[12],  [  ],  [  ],  [12],  [31],  [12],  [  ],  [  ],  [  ],  [12],  [  ],  [  ],  [  ],  [  ],  [  ],  [  ],  [  ],  [  ],  [  ],  [12]],
  [[12],  [  ],  [  ],  [12],  [  ],  [12],  [  ],  [  ],  [  ],  [12],  [  ],  [  ],  [  ],  [  ],  [  ],  [  ],  [  ],  [  ],  [  ],  [12]],
  [[12],  [  ],  [  ],  [  ],  [  ],  [12],  [  ],  [  ],  [  ],  [12],  [  ],  [  ],  [  ],  [  ],  [  ],  [  ],  [  ],  [  ],  [  ],  [12]],
  [[12],  [  ],  [12],  [12],  [  ],  [12],  [  ],  [  ],  [  ],  [12],  [  ],  [  ],  [  ],  [  ],  [  ],  [  ],  [  ],  [  ],  [  ],  [12]],
  [[12],  [  ],  [12],  [  ],  [  ],  [  ],  [  ],  [  ],  [  ],  [12],  [  ],  [  ],  [  ],  [  ],  [  ],  [  ],  [  ],  [  ],  [  ],  [12]],
  [[12],  [  ],  [12],  [  ],  [  ],  [12],  [  ],  [  ],  [  ],  [12],  [  ],  [  ],  [  ],  [  ],  [  ],  [  ],  [  ],  [  ],  [  ],  [12]],
  [[12],  [  ],  [12],  [  ],  [  ],  [12],  [  ],  [  ],  [  ],  [12],  [  ],  [  ],  [  ],  [  ],  [  ],  [  ],  [  ],  [  ],  [  ],  [12]],
  [[12],  [  ],  [12],  [  ],  [  ],  [12],  [  ],  [  ],  [  ],  [12],  [  ],  [  ],  [  ],  [  ],  [  ],  [  ],  [  ],  [  ],  [  ],  [12]],
  [[12],  [  ],  [12],  [  ],  [  ],  [12],  [  ],  [  ],  [  ],  [12],  [  ],  [  ],  [  ],  [  ],  [  ],  [  ],  [  ],  [  ],  [  ],  [12]],
  [[12],  [30],  [12],  [  ],  [  ],  [12],  [  ],  [  ],  [  ],  [12],  [  ],  [  ],  [  ],  [  ],  [  ],  [  ],  [  ],  [  ],  [  ],  [12]],
  [[12],  [12],  [12],  [  ],  [  ],  [12],  [  ],  [  ],  [  ],  [12],  [  ],  [  ],  [  ],  [  ],  [  ],  [  ],  [  ],  [  ],  [  ],  [12]],
  [[12],  [  ],  [  ],  [  ],  [  ],  [12],  [  ],  [  ],  [  ],  [12],  [  ],  [  ],  [  ],  [  ],  [  ],  [  ],  [  ],  [  ],  [  ],  [12]],
  [[12],  [  ],  [  ],  [  ],  [  ],  [12],  [  ],  [  ],  [  ],  [12],  [  ],  [  ],  [  ],  [  ],  [  ],  [  ],  [  ],  [  ],  [  ],  [12]],
  [[12],  [  ],  [  ],  [  ],  [  ],  [12],  [  ],  [  ],  [  ],  [12],  [  ],  [  ],  [  ],  [  ],  [  ],  [  ],  [  ],  [  ],  [  ],  [12]],
  [[12],  [  ],  [  ],  [  ],  [  ],  [12],  [  ],  [  ],  [  ],  [  ],  [  ],  [  ],  [  ],  [  ],  [  ],  [  ],  [  ],  [  ],  [  ],  [12]],
  [[12],  [  ],  [  ],  [1 ],  [  ],  [12],  [30],  [  ],  [  ],  [12],  [  ],  [  ],  [  ],  [  ],  [  ],  [  ],  [  ],  [  ],  [  ],  [12]],
  [[12],  [12],  [12],  [10],  [11],  [12],  [12],  [12],  [12],  [12],  [12],  [12],  [12],  [10],  [11],  [12],  [12],  [12],  [12],  [12]]
]
